55555555551212111231233
55555555551231333121112
55555555551122131231322
55555555554444444444444
55555555554444444444444
55555555554444444444444
55555555554444444444444
###target_time:6|min_stones:4