3314431343
4424141411
1121121223
1223343434
3424343423
3444113343
4421241411
3224142411
3132323322
3334343434
###target_time:100|min_stones:3