133415541144324
221444444425233
231232251321134
243333321431424
134551452424533
545434433133221
113443252322532
131223415324213
512413522521551
351422113322151
###target_time:150|min_stones:2