1212121231233
1231233121212
1223123311221
1231233121212
4444400555555
1122131233122
1223123311221
###target_time:139|min_stones:2