1212121231233
1231233121212
1122131233122
1223123311221
1231233121212
1122131233122
1223123311221
###target_time:6|min_stones:3