11311131
13311133
11113322
32122322
12222122
12111332
###target_time:48|min_stones:3